metric,date,Fraser,Interior,Vancouver Island,Northern,Vancouver Coastal,Total BC
deaths,7-4-2020,8,0,2,0,33,43
deaths,6-4-2020,7,0,2,0,30,39
deaths,1-4-2020,4,0,0,0,21,25
deaths,2-4-2020,5,0,2,0,24,31
deaths,3-4-2020,5,0,2,0,28,35
deaths,27-3-2020,2,0,0,0,14,16
deaths,26-3-2020,2,0,0,0,12,14
deaths,30-3-2020,2,0,0,0,17,19
deaths,24-3-2020,2,0,0,0,11,13
deaths,25-3-2020,2,0,0,0,12,14
deaths,31-3-2020,3,0,0,0,21,24
deaths,23-3-2020,2,0,0,0,11,13
