metric,date,Fraser,Interior,Vancouver Island,Northern,Vancouver Coastal,Total BC
recovered,1-4-2020,176,27,27,5,371,606
recovered,2-4-2020,192,29,29,7,384,641
recovered,3-4-2020,203,35,31,7,397,673
recovered,27-3-2020,90,13,8,5,159,275
recovered,26-3-2020,5,9,8,5,159,186
recovered,30-3-2020,147,19,24,5,274,469
recovered,24-3-2020,3,8,0,4,158,173
recovered,25-3-2020,3,8,6,5,161,183
recovered,31-3-2020,163,22,26,5,291,507
recovered,23-3-2020,2,8,0,0,136,146
